MAZE: "mylevel", ' '
FLAGS:premapped
GEOMETRY:center,center
MAP
|-----     ------
|.....-- --.....|
|.T.T...-....K..|
|.......+.......|
|.T.T...-.......|
|.....-----.....|
|-----     ------
ENDMAP
BRANCH: (3,3,3,3),(4,4,4,4)